w                              w
w                              w
w                              w
w                              w
w                              w
w                              w
w                              w
w                              w
we                             w
wwwww                          w
w        www                   w
w              ww              w
w                       n      w
w                       w      w
w                   w          w
w s              w             w
w             w                w
wwwwwwwhhhwwwwwwhhhhhwwwwwwwwwww
