wwwwwwwwwwwwwwwwwwwwwwwwwwwwwwwwwwwwwwwwwwwwwwwwwwwwwwwwwwwwwwwwwwwwwwwwwwwwwwwwwwwwwww
w                                                                                     w
w                                                                                     w
w                                                                                     w
w                                                                                     w
w                                                                                     w
w                                                                                     w
w                                                                 ff                  w
w                                                                                     w
w                                             f    ff           f                     w
w             f            f            f               f                             w
w        f             f             f                            ff                  w
w ff             fff         ff                   ffff                    ff          w
wx    f          www                ff                          f                     w
w                www       ff               ff             f         ff               w
w s      fff     www fff         ff      f           ff                            eeew
wfffffffhhhhhhhhhfffhhhhhhhhhhhhhhhhhhhhhhhhhhhhhhhhhhhhhhhhhhhhhhhhhhhhhhhhhhhhfffeeew