w                              w
w                              w
w                              w
w                              w
w                              w
w                              w
w                              w
w                              w
we                             w
wwwww                          w
w        w                     w
w           w                  w
w                        n     w
w             w          w     w
w                w             w
w s                  w         w
w             w                w
wwwwwwwhhhwwwwwwhhhhhwwwwwwwwwww
