wwwwwwwwwwwwwwwwwwwwwwwwwwwwwwwwwwwwww
w                                    w
w                                    w
w                                    w
w                                    w
w                                    w
w                                    w
w                                    w
w                                    w
w                                    w
w                                    w
w                                    w
wffffff                              w
w                                    w
w                                    w
w                                    w
w                                    w
wfffffffffffffffffffffffffffffff    fw
w                                    w
w                                ff  w
w                             ff     w
w                          ff        w
w                      ff            w
w               ff                   w
w        ff                          w
w   f                                w
wfffff                               w
w        ff                          w
w            ff                      w
w                                    w
w       v       f                    w
wfffft      fffffffffffffffffffffffffw
w       ff                           w
w          ff                        w
w                        l           w
w           fff                      w
w       ff f    ff   ff              w
w      f                   f         w
w     f                  ffffffffffffw
w    f                ff             w
w  s              ff                 w
w  f         ff                      w
wc        ff                       x w
wfffhhhhfffffffhhhfffffffffffffffffffw