wwwwwwwwwwwwwwwwwwwwwwwwwwwwwwwwwwwwww
w                                    w
w                                    w
w                                    w
w                                    w
wffffffffffffffffffffffffffffffffffffw
wffffffffffffffffffffffffffffffffffffw
wffffffffffffffffffffffffffffffffffffw
wffffffffffffffffffffffffffffffffffffw
wffffffffffffffffffffffffffffffffffffw
wffffffffffffffffffffffffffffffffffffw
wffffffffffffffffffffffffffffffffffffw
wffffffffffffffffffffffffffffffffffffw
w      w                             w
we     w                             w
wff    w                             w
w      w         t                   w
w     ffff      f  fff               w
w                                    w
w  f                                tw
w   f                               fw
w    f  vv          vv               w
wfffffffffffhhhhhhffffffffffff       w
wffffffffffffffffffffffffffffff      w
w                               f    w
w                                    w
w     v   v                         fw
w   ffffffffff                     fww
w                                 fwww
wf           t                   fwwww
wfff        fffffffffhhhhhfffffffffffw
wffff       fffffffffffffffffffffffffw
w       ff                           w
w                                    w
w   f                                w
w                                    w
wf                                   w
wl                 lf                w
wfffffffffffffffffffffhhhhhfffff     w
wffffffffffffffffffffffffffffffff    w
w                                   fw
w                                    w
w s       v   v   v   v          f   w
wfffhhhhfffffffhhffhhffffffffffffffffw