wwwwwwwwwwwwwwwwwwwwwwwwwwwwwwwwwwwwww
w                                    w
w                                    w
w                                    w
w                                    w
w                                    w
w                                    w
w                                    w
w                                    w
w                                    w
w                                    w
w                                    w
wffffff                              w
w                                    w
w                                    w
w                                    w
w                                    w
wfffffffffffffffffffffffffffffff    fw
w                                    w
w                                ff  w
w                             ff     w
w                          ff        w
w                      ff            w
w               ff                   w
w        ff                          w
w   f                                w
wfffff                               w
w        ff                          w
w            ff                      w
w                                    w
w               f                    w
wffff       fffffffffffffffffffffffffw
w       ff                           w
w          ff                        w
w                                    w
w            ff                      w
w               ff   ff    n         w
w                          f         w
w                        ffffffffffffw
w                     ff             w
w                 ff                 w
w            ff                      w
w s       ff                         w
wfffhhhhfffffffffffffffffffffffffffffw
wwwwwwwwwwwwwwwwwwwwwwwwwwwwwwwwwwwwww