wwwwwwwwwwwwwwwwwwwwwwwwwwwwwwwwwwwwwwwwwwwwwwwwwwwwwwwwwwwwwwwwwwwwwwwwwwwwwwwwwwwwwww
w                                                                                     w
w                                                                                     w
w                                                                                     w
w                                                                                     w
w                                                                                     w
w                                                                                     w
w                                                                                     w
w                                                                                     w
w                                                                 ff                  w
w                                                                                     w
w                                             f    ff           f                     w
w                          f            f               f                             w
w                      f             f                            ff                  w
w ff         f   fff         ff                   ffff                    ff          w
wx       f       www                ff                          f                     w
w                www       ff               ff             f         ff        ff     w
w  s  f          www                                                                eew
wfffffffhhhhhhhhhfffhhhhhhhhhhhhhhhhhhhhhhhhhhhhhhhhhhhhhhhhhhhhhhhhhhhhhhhhhhhhffffffw
wfffffffffffffffffffffffffffffffffffffffffffffffffffffffffffffffffffffffffffffffffffffw
wfffffffffffffffffffffffffffffffffffffffffffffffffffffffffffffffffffffffffffffffffffffw
wfffffffffffffffffffffffffffffffffffffffffffffffffffffffffffffffffffffffffffffffffffffw
wfffffffffffffffffffffffffffffffffffffffffffffffffffffffffffffffffffffffffffffffffffffw